###f####
##cAd###
###e####
#   ####
B ######