###f####
##cA ###
###e####
#   ####
B ######
