########
###A####
### ####
#   ####
B ######