###########
###########
###B##A ###
### ### ###
### ### ###
#   ### ###
# ##### ###
# ##    ###
#     #####
###########